9 14
   +++++++    
   +++++++    
====     ===  
===       ==  
===       ==  
=*=  ====+++++
===  ====+++++
     =x=  ++=+
     ===  ++++